1x=一
2j=辻
2v=毅
2x=二
3ak=滉
3f=渉
3k=洸
3l=沙
3t=汰
3x=三
3y=湧
4x=四
5x=五
6x=六
7k=之
7x=七
8x=八
9x=九
a2=敦
a3=彰
a4=晃
ad=赤
ag=合
aj=秋
ak=亜
al=綾
am=天
ar=有
as=麻
at=篤
aw=亞
ax=杏
az=東
bb=美
bc=渕
bd=部
bf=駿
bk=黒
bl=咲
bm=勉
bn=敏
br=丸
bs=隼
bt=端
bw=弓
bx=武
c2=番
c3=号
c8=籠
c9=篭
cc=斗
cd=章
cf=金
ch=司
cj=梶
ck=竹
cl=澄
cn=間
cg=志
cd=貴
cm=鎌
cp=社
cr=知
cs=会
ct=片
cw=町
cx=神
d8=龍
db=大
dc=土
dd=髙
df=太
dk=徳
dn=第
dr=夢
ds=修
dy=代
e2=悦
eb=枝
ec=絵
eg=江
eh=英
ek=益
em=恵
eq=等
es=哲
ev=夕
ex=榎
fb=吹
fc=淵
fd=吉
ff=北
fg=凪
fj=藤
fk=福
fl=友
fm=文
fn=夏
fr=古
fs=深
fw=歩
gb=郷
gc=口
gd=剛
gg=永
gh=吾
gj=垣
gk=学
gl=溝
gm=雅
gq=越
gs=菅
gt=月
gw=河
gy=義
h2=弘
h3=宏
h4=原
h5=伍
hb=橋
hc=彦
hd=秀
hf=心
hg=萩
hh=広
hj=聖
hk=博
hl=葉
hm=公
hn=本
hp=帆
hq=久
hr=裕
hs=濱
ht=人
hv=堀
hw=範
hx=平
hy=濵
hz=早
i1=十
i2=百
i3=千
i4=万
i5=尹
ib=胃
ic=市
id=井
if=稲
ig=偉
ih=伊
ij=維
ik=衣
il=紗
im=以
is=石
it=一
iv=尹
iw=岩
iy=韋
iz=依
jb=丈
jc=樹
jd=充
jf=嗣
jg=織
jh=仁
jj=木
jk=治
jl=住
jm=嶋
jn=淳
jp=純
jr=真
js=順
jt=潤
k2=賢
k3=啓
k4=圭
k5=敬
k8=憲
kb=希
kc=華
kd=次
kf=花
kg=紀
kh=浩
kj=記
kl=孝
km=寛
kn=健
kq=清
kr=香
ks=佳
kt=輝
kv=勝
kw=川
kx=小
ky=喜
kz=克
l8=音
lb=矢
ld=横
ll=結
lv=愛
m2=昌
m3=光
m8=宮
mb=基
mc=芽
md=向
mf=森
mg=磨
mh=眞
mk=亮
ml=萌
mm=海
mn=元
mp=紫
mr=村
ms=正
mt=松
mx=満
my=宮
mz=水
n2=信
n3=伸
nb=暢
nc=今
nd=直
nf=菜
ng=長
nh=那
nj=成
nk=中
nl=乃
nm=々
nn=野
nr=奈
ns=西
nt=日
nw=庭
nz=望
ob=覚
oc=岡
og=緒
oh=央
oj=伯
ok=男
or=己
os=雄
ot=夫
pj=邦
pp=春
ps=者
r9=陸
rc=涼
rf=荒
rg=悟
rh=朗
rj=郎
rk=理
rl=生
rm=路
rn=林
rp=利
rq=莉
rr=梨
rs=里
rt=立
rw=倉
ry=御
s2=節
s3=寿
s4=紳
sb=柴
sc=坂
sd=貞
sf=史
sg=将
sh=周
sj=新
sk=介
sl=佐
sm=島
sn=慎
sq=栄
sr=彩
ss=士
st=幸
sv=誠
sw=昭
sx=篠
sy=祥
sz=沢
t2=津
t3=塚
t4=崇
t5=徹
t8=瀧
t9=滝
tb=飛
tc=登
td=戸
tg=颯
th=達
tj=拓
tk=隆
tl=琢
tm=智
tn=田
tp=寺
tq=泰
ts=俊
tt=高
tv=谷
ty=豊
uc=内
uh=于
uj=氏
uk=于
um=馬
up=植
uq=上
ur=浦
us=宇
ut=打
vv=子
wc=若
wg=羽
wh=白
wl=翔
wn=風
ws=渡
ww=和
xx=聡
y2=佑
y4=行
yc=康
yd=屋
yf=由
yg=柳
yh=陽
yk=之
yl=洋
ym=山
yn=哉
yr=良
ys=安
yt=也
yv=勇
yw=世
yy=祐
yz=優
zb=瑞
zf=前
zk=﨑
zn=善
zs=崎
zz=澤
aag=縣
aaj=絢
aak=茜
aam=尼
aar=甲
aat=當
aib=相
aih=灰
ain=庵
ais=芦
2al=凌
aob=青
ha1=侑
aut=厚
auz=梓
be8=鈴
baj=場
bak=化
bas=伴
bay=芭
bek=黑
bex=局
bis=窪
bit=尾
bik=椿
bod=板
bot=両
box=箱
buk=栞
bum=熊
bun=分
bur=岐
cal=寒
cam=會
can=叶
car=車
cas=詠
cat=暁
cav=洞
cib=橘
cig=地
cin=鎮
cir=円
cis=晶
coh=張
col=色
com=彗
coq=征
cot=慧
cow=牛
cuk=苅
cur=冠
cus=刈
cut=切
do9=竜
dab=暖
dag=団
dan=段
dec=宣
dek=台
dem=院
der=鹿
dex=出
dir=乾
doc=落
dog=德
doh=堂
doj=壌
dok=所
dom=留
dor=努
eeg=苑
eem=惠
eis=衛
eos=袁
fag=渚
fal=旗
fax=工
feg=舷
fek=舩
fen=船
fes=舟
fir=先
fis=魚
fom=冨
for=袋
fot=足
fow=徃
fu1=丕
fuf=晋
fuk=吹
fuk=府
ful=床
fum=富
fur=友
fut=普
fuy=芙
fuz=附
gad=園
gaj=岳
gar=駕
gas=賀
gat=潟
geg=玉
gek=玄
gem=厳
gen=源
ger=繁
get=弦
wim=泳
gij=技
gis=魏
giw=際
god=豪
gof=後
goj=后
gok=梧
gom=護
gon=権
got=取
guc=郡
guf=軍
gug=群
gur=蔵
gus=櫛
hab=幅
hac=悠
haf=半
hag=反
haj=肇
hak=遥
ham=浜
han=畔
har=晴
has=蓮
hat=畠
hav=速
haw=鷹
hay=侑
heb=碧
hed=頭
heh=邊
hek=邉
hem=姫
hen=辺
heq=榮
het=入
hi3=焱
hi4=燚
hib=響
hib=緋
hig=樋
hik=斐
hil=丘
him=妃
hip=尻
hiq=均
hir=尋
his=尚
hit=瞳
hiy=儀
ha1=匡
ha2=匠
hoc=灯
hod=方
hoh=穂
hok=阪
hol=細
hom=穗
hon=角
hop=誉
hor=惺
hos=星
hot=保
hi2=廣
ke1=畑
huh=狩
huk=比
hus=家
iar=幾
ias=潔
iat=威
ies=育
iih=紘
iik=壱
iiz=泉
ion=猪
ios=功
iot=糸
ti1=至
ti2=致
iuk=郁
ia1=巌
ia2=巖
jad=翠
jan=睦
jib=自
jid=児
jig=兒
jij=事
jik=實
jim=爾
jis=岸
jit=実
jiz=慈
joh=常
jok=條
jor=条
jug=諄
juh=重
kkab=可
kad=階
kaf=完
kag=科
kaj=果
kak=掛
kam=亀
kan=勘
kar=唐
kas=笠
kat=加
kaw=柏
kay=伽
ba1=椛
ba3=騎
ba2=樺
2ib=冴
ka8=架
keb=顕
ked=楓
kej=慶
kek=気
kem=兼
ken=謙
kep=県
kes=建
kex=ヶ
key=氣
kez=梢
kib=綺
kic=黃
kid=起
kif=黄
kih=妃
kik=國
kil=軌
kim=奇
kin=国
kip=期
kir=規
kis=季
kit=桐
kiy=居
ka4=桂
ku1=隅
ku2=隈
ki1=欽
kog=鴻
koh=畔
kom=駒
kon=享
kor=航
kos=胡
kow=耕
koy=教
ka2=薫
ka3=嘉
ki2=耀
ko3=壽
kud=区
kug=草
kuk=矩
kum=君
kun=訓
kur=来
kus=楠
kuz=葛
ko1=京
ko2=興
2ok=凉
ko3=恭
law=法
lef=左
lek=好
let=字
lik=凜
lin=線
liq=酒
lir=璃
lis=凛
lur=瑠
mad=舞
mah=槇
mak=牧
mam=摩
mar=茉
mas=政
maw=巻
may=馳
maz=増
meg=茂
meh=毛
mek=明
mem=員
mes=瞬
mey=目
mi2=峯
mi3=嶺
mib=身
mic=道
mid=緑
mif=皆
mig=貢
mik=幹
mil=見
mim=南
min=峰
mir=未
mis=巳
moc=持
mod=蒔
mog=旭
moh=猛
moj=桒
mok=桑
mol=盛
mom=守
mon=門
mop=桃
mor=朝
mos=最
mot=湊
muf=宗
mug=棟
muj=務
mun=稔
mi2=冰
3iz=湖
nab=鍋
nad=灘
nag=迅
nah=仲
nal=稜
nam=並
nam=名
nan=何
nap=難
nar=鳴
nas=茄
nat=昊
naw=苗
nay=浪
neb=延
neg=祢
nen=然
ner=根
nes=巣
net=網
3ag=流
ni3=晄
nij=晟
nik=貫
niy=晏
na3=沖
nob=忍
noc=埜
nod=温
noh=能
noj=穣
nok=穏
nor=宜
nor=穰
noy=納
na2=捺
nu1=数
nu2=數
nug=暉
num=沼
num=数
nus=主
oam=阿
oeg=琉
oeh=瑛
oek=旺
oen=琳
oeq=玖
oer=玲
oez=瑚
oig=鬼
oa1=恩
oog=荻
ook=奥
ou2=脩
ouc=乙
ouj=皇
ouk=王
pap=紙
par=巴
pat=形
pod=池
por=要
pub=示
pul=引
pum=梅
pus=押
put=置
quy=粂
rak=楽
ral=陵
ram=雨
rar=稀
raw=恒
red=朱
ren=連
rer=礼
ric=快
rid=乗
rih=倫
rik=力
rim=李
rip=俐
rit=律
ri3=彬
3ir=淋
rod=僚
rof=呂
roh=弄
roj=老
rok=諒
rom=室
rom=瞭
ron=遼
rop=綱
ruk=栗
rur=憂
ro2=凌
sab=榊
sac=堺
dos=砂
sah=浅
saj=城
sak=作
sal=塩
sam=少
sap=鋭
sar=桜
sas=笹
sat=始
saw=爽
saz=淺
sad=定
se2=輔
sa3=禎
sed=仙
sef=瀬
sej=関
sek=瀨
sel=貝
sem=迫
sep=研
ser=芹
sey=勢
so2=將
sib=芝
sic=視
sif=柊
sig=滋
sih=愼
sij=渋
sik=澁
sil=視
sim=如
sin=景
sip=詩
sir=吏
sit=下
siw=師
siy=昇
siz=静
sa1=朔
se1=助
sob=境
soc=磯
sod=種
sog=礒
soh=資
soj=曽
sok=則
som=曾
sop=奏
sor=空
sos=蘇
sow=壮
soy=荘
soz=創
sa2=倖
su5=巢
sub=昂
suc=杉
sud=須
suw=末
suh=収
suj=淑
suk=皓
sum=進
sun=舜
sus=洲
suy=州
tab=環
tac=舘
tad=忠
taf=棚
taj=丹
tak=卓
tam=珠
taq=妙
tar=樽
tas=辰
tat=多
taw=淡
tay=嵩
to3=燈
to2=轟
teg=揮
teh=手
tej=展
ten=典
ter=照
tes=宝
tic=馳
tig=稚
tih=陳
tik=近
tim=巧
tin=关
tiw=双
ci1=筑
ci2=築
ta2=隆
to5=透
tu2=⻆
tod=通
tof=遠
tog=統
toh=亨
toj=時
tok=督
tom=朋
ton=豕
tor=鳥
tos=年
tot=都
tow=塔
toy=峻
to2=竣
tub=坪
tud=續
tug=継
tuk=槻
tum=燕
tum=堤
tur=鶴
tus=翼
tut=筒
tuy=宙
uar=麗
uug=臼
uus=薄
vir=仮
wac=輪
waj=脇
wak=涌
wan=幡
war=我
was=鷲
wat=亘
wav=波
wif=妻
wig=翼
wit=冬
wor=笑
yag=栁
yak=宅
yal=崚
yam=耶
yan=稜
yas=靖
yat=館
yay=弥
yab=薮
yis=椰
yiy=唯
yob=予
yoc=祥
yog=奨
yoh=庸
yoj=庄
yok=與
yol=頼
yon=米
yor=萬
yos=芳
yot=与
yoz=省
yu3=汐
yu3=祐
yub=兪
yuc=祐
yuh=湯
yuj=彌
yuk=雪
yup=遊
yur=愉
yus=諭
yuy=釉
yuz=柚
zak=嵜
zal=陵
zar=櫻
zas=財
zeb=全
zes=是
zos=造
zum=積
zut=図
